R 1920 1080
NO ./textures/wood.xpm
SO ./textures/colorstone.xpm
WE ./textures/bluestone.xpm
EA ./textures/greystone.xpm

S ./textures/barrel.xpm
F 30,225,0
C 0,0,220

        1111111111111111111111111
        1000000000110000000000001
        1011000001110000002000001
        1001000000200000000200001
111111111011020001110000002000001
100022000011002001110111111111111
11110111111111011100000010001
11110111111111011101010010001
11200020110101011100000010201
10002W00200000001100000010201
10000200020002001101010010201
1122000111010101111101111010111
11110111 1110101 101111010001
11111111 1111111 111111111111